###############################
#.............#.............#
#.####.#####.###.#####.####.#
#.#  #.#   #.#   #.#   #.#  #
#.####.### #.### #.### ####.#
#......#   #.....#.....#.....#
#.####.# #####.#.#####.#.#####
#.####.#     #.#     #.#.#####
#......# ### #.### ### #.....#
#####.### #.......# #.########
     #.#   #.###.#   #.#      
#####.# ### # # # ###.#.######
      .  #   # # #   #  .     
#####.# ### ##### ###.#.######
     #.#   #.......#   #.#      
########.### #.# #.###.########
#.............#.............#
#.####.#####.###.#####.####.#
#...#.......#.....#.......#..#
###.#.#.#####.#.#.#####.#.#.###
#.....#........ ........#.....#
###############################